8 10 12 8 10 12 33 14 17 55 39
9 11 13 9 11 13 34 13 16 54 41
45 47 49 50 47 45 49 45 49 52 41
46 48 46 46 48 46 46 46 46 0 0
12 12 12 10 10 0 0 0 0 0
7 6 5 4 11 13
0 0 0 0 
