39 39 39 00 00 00 00 00 00 65 55 39
00 00 39 00 00 00 00 00 00 17 55 39
00 00 39 00 00 00 00 00 00 17 55 39
00 00 39 00 00 00 00 00 00 17 55 39
00 00 00 00 00 00 00 00 00 17 55 41
12 08 10 12 08 10 12 33 14 17 55 39
09 09 11 13 09 11 13 34 13 16 54 41
45 45 47 49 50 47 45 49 45 49 52 41
46 46 48 46 46 48 46 46 46 46 00 00
00 12 12 12 10 10 00 00 00 00 00
00 07 06 05 13 11 13

